11100000000000010000000000001000000011111111000000
00111110000001110000000100001000000010000001000000
00100010000001000100000100001111111110011111000000
11100011110001111110000100001000010000010001000000
10000000010001000000000100111111110000010011000000
10000000010001000000000111100000010000010010000000
10000000010001110000000000100000011111110011111100
10001111011111010000001111100000000010000010000000
10001001110001111110001100000111100010000010000000
10001000000000000010000100000100100010000010000000
10111000000000110010000111111100111000111110000000
10101111111110010010000010000000001000100000000100
10000000000010010010011110000000111111100000000000
10011000000010010011110011100000100000111100000000
10110010001110010011000000110000110000000111000000
10100010001010010001000011110000010000000001000000
11100011111011110011000000000000010000111111000000
10000001001000011110000000000000010000100000000000
10011000001000010000001111111111011111100000000000
10010011101111111111001000010000000010000111100000
10111010111000000001111000011110000010000100000000
10101110000000001111001000000011111111100111110000
11100000000111111000001111100010000000111100010000
10001011111100010000000000111111100000100000011100
10011010000000011100000000100000100000100000010000
11110110000000000111111111100000111111100000110000
11000111111111000100000011000000000011000000100000
01000100000001000100111010000000000010001111100000
01110100000001000111100011111111111111101000001000
00010111111100000001000001000001000000111000001000
00010000100110000001111111000001001000001000001000
00011111100010011111000010000001001000001111111000
00000000111111110000000010001111001000000100001000
00000000000000010111101111111000001111111100000000
00000110011110011100001000000000011000000111100000
00001011110011110111001111111111110000000100111000
00111000000000010001001000000000000000011100000000
00001111110000011111111001111111111000010000011100
00001000001111110000000001000000001001110000110100
00001101111001000000000111000011111111000000100000
00000111000001111111111100000010000001000000100000
00000001000000000000010000000011111001111100100000
00000000000000000000011000000000001000000100100000
00011111000000000000001111111111111000001111100000
00000001000000001111111000000000100001111000000000
00000001111000001000000000001000100011000000111000
00000000001001111001111111111110000000011110101000
00000000001111000000010000000000111111110011101100
00000000000001000000110000011111100000000000000110
00000000000001111111100000000000000000000000000000